300 25
200000000000000000000000000000000000000000000000000000000000000000000000000000000000000000000000000000000000000000000000000000000000000000000000000000000000000000000000000000000000000000000000000000000000000000000000000000000000000000000000000000000000000000000000000000000000000000000000000000000002
000000000000000000000000000000000000000000000000000000000000000000000000000000000000000000000000000000000000000000000000000000000000000000000000000000000000000000000000000000000000000000000000000000000000000000000000000000000000000000000000000000000000000000000000000000000000000000000000000000000000
000000000000000000000000000000000000000000000000000000000000000000000000000000000000000000000000000000000000000000000000000000000000000000000000000000000000000000000000000000000000000000000000000000000000000000000000000000000000000000000000000000000000000000000000000000000000000000000000000000000000
000000000000000000000000000000000000000000000000000000000000000000000000000000000000000000000000000000000000000000000000000000000000000000000000000000000000000000000000000000000000000000000000000000000000000000000000000000000000000000000000000000000000000000000000000000000000000000000000000000000000
000000000000000000000000000000000000000000000000000000000000000000000000000000000000000000000000000000000000000000000000000000000000000000000000000000000000000000000000000000000000000000000000000000000000000000000000000000000000000000000000000000000000000000000000000000000000000000000000000000000000
000000000000000000000000000000000000000000000000000000000000000000000000000000000000000000000000000000000000000000000000000000000000000000000000000000000000000000000000000000000000000000000000000000000000000000000000000000000000000000000000000000000000000000000000000000000000000000000000000000000000
00000000000000000000000000000000000000000000000000000000000000000000000000000000000000ooooo0000000000000000000000000000000000000000000000000000000000000000000000000000000000000000000000000000000000000000000000000000000000000000000000000000000000000000000000000000000000ooooo00000000000000000000000000
0000000000000000000000000000000000000000000000000000000000000000000000000000000000000ooooooo000000000000000000000000000000000000000000000000000000000000000000000000000000000000000000000000000000000ooooo000000000000000000000000000000000000000000000000000000000000000000ooooooo0000000000000000000000000
0000000000000000000000000000000000000000000000ooooo00000000000000000000000000000000000ooooo000000000000000000000000000000000000000000000000000000000000000000000000000000000000000000000000000000000ooooooo000000000000000000000000000000000000000000000000000000000000000000ooooo00000000000000000000000000
000000000000000000000000000000000000000000000ooooooo0000000000000000000000000000000000000000000000000000000000000000000000000000000000000000000000000000000000000000000000000000000000000000000000000ooooo00000000000000000000000000000000000000000000000000000000000000000000000000000000000000000000000000
0000000000000000000000000000000000000000000000ooooo00000000000000000000000000000000000000000000000000000000000000000000000000000000000000000ooooo00000000000000000000000000000000000000000000000000000000000000000000000000000000000000000000000000000000000000000000000000000000000000000000000000000000000
0000000000000000000000000000000000000000000000000000000000000000000000000000000000000000000000000000000000000000000000000000000000000000000ooooooo0000000000000000000000000000000000000000000000000000000000000000000000000000000000000000000000000000000000000000000000000000000000000000000000000000000000
00000000000000000000000000000000000000000000000000000000000000000000000000000000000000000000000000000000000000000000000000000000000000000000ooooo00000000000000000000000000000000000000000000000000000000000000000000000000000000000000000000000000000000000000000000000000000000000000000000000000000000000
000000000000000000000000000000000000000000000000000000000000000000000000000000000000000000000000000000000000000000000000000000000000000000000000000000000000000000000000000000000000000000000000000000000000000000000000000000000000000000000000000000000000000000000000000000000000000000000000000000000000
200000000000000000000000000000000000000000000000000000000000000000000000000000000000000000000000000000000000000000000000000000000000000000000000000000000000000000000000000000000000000000000000000000000000000000000000000000000000000000000000000000000000000000000000000000000000000000000000000000000000
200000000000000000000000000000000000000000000000002222222222000000000000000000000000000000000000000022222222222222222222222222222200000000000000000000000000000000000000002222222222222222220000000000000000000000000000000000000000000000000022222222222222222222222222222222222220000000000000000000000000
222222220000000022222222222222000000022222222222222222222222000000000000000000002222222222002222222222222222222222222222222222222222222200000000000000222222222220000000002222222222222222222222000000000000000000002222222220000000000000222222222222222222222222222222222222222222222222222220000000000000
222222222002222222222222222222200000222222222222222222222222220000000000000000022222222222202222222222222222222222222222222222222222222222222000000002222222222222000000002222222222222222222222222222000000000000022222222222000000000222222222222222222222222222222222222222222222222222222222222000000000
222222222022222222222222222222220002222222222222222222222222222000000000000000222222222222222222222222222222222222222222222222222222222222222222222222222222222222000000222222222222222222222222222222222222222222222222222222000022222222222222222222222222222222222222222222222222222222222222222222200000
222222222222222222222222222222222022222222222222222222222222222222000000002222222222222222222222222222222222222222222222222222222222222222222222222222222222222222220022222222222222222222222222222222222222222222222222222222200222222222222222222222222222222222222222222222222222222222222222222222222222
222222222222222222222222222222222222222222222222222222222222222222220000022222222222222222222222222222222222222222222222222222222222222222222222222222222222222222220022222222222222222222222222222222222222222222222222222222200222222222222222222222222222222222222222222222222222222222222222222222222222
222222222222222222222222222222222222222222222222222222222222222222222000222222222222222222222222222222222222222222222222222222222222222222222222222222222222222222222022222222222222222222222222222222222222222222222222222222202222222222222222222222222222222222222222222222222222222222222222222222222222
222222222222222222222222222222222222222222222222222222222222222222222202222222222222222222222222222222222222222222222222222222222222222222222222222222222222222222222222222222222222222222222222222222222222222222222222222222222222222222222222222222222222222222222222222222222222222222222222222222222222
222222222222222222222222222222222222222222222222222222222222222222222222222222222222222222222222222222222222222222222222222222222222222222222222222222222222222222222222222222222222222222222222222222222222222222222222222222222222222222222222222222222222222222222222222222222222222222222222222222222222
222222222222222222222222222222222222222222222222222222222222222222222222222222222222222222222222222222222222222222222222222222222222222222222222222222222222222222222222222222222222222222222222222222222222222222222222222222222222222222222222222222222222222222222222222222222222222222222222222222222222